__________
X_________
__________
__________
__________
__________
__________
TTTTTTTTTT